10001100
00000001
00000000
00000000
10001100
00000010
00000000
00000100
00000000
00100010
00011000
00100001
00000000
00100010
00100000
00100011
00000000
00100010
00101000
00100100
00000000
00100010 
00110000
00100101
00000000
00100010
00111000
00100111
00001000
00000000
00000000
00001001
10101100
00000001
00000000
00001000
00010000
00100110
00000000
00000010
10101100
00000001
00000000
00001000
00100100
11101000
00000000
00000001
10101100
00001000
00000000
00001000
00000000
00000000
00000000
00100001
00000000
00000000
00000000
00100001
11111111
11111111
11111111
11111111
